111111111111111111111111111111111111111111111111111111111111111111111111111111111111111111111111111111111111111111111111111111111111
10010000000C0000000010001111111100000000010000000000010000000C0000000010001111111100000000010000000000000000000000000000000000000011
1000011111001000000000000000100000000000000010000000010000000C0000000010001111111100000000010000000000000000000000000000000000000011
1000110000001111111111110000000000000000111111111110010000000C0000000010001111111100000000010000000000000000000000000000000000000011
11000000C0001111111111111100000000000000000000000000010000000C0000000010001111111100000000010000000000000000000000000000000000000011
1000000000000000000000011000000000000000000000000000010000000C0000000010001111111100000000010000000000000000000000000000000000000011
10000000000000000000000110000P0000000000000000000000010000000C0000000010000000000000000000010000000000000000000000000000000000000011
10000111110010000000000110001000000000000000100000000010000000C000000001000000000000000000000000000000000000000000000000000000000011
10000111110010000000000000001000000000000000100C00011000000000000000100C00011000000000000000000C000110000000000000000000000000000011
10000000000010000011111000001000000000E00000100000011000000000000000100C00011000000000000000000C000110000000000000000000000000000011
10000111110010000000000000001000000000000000100000011000000000000000100C00011000000000000000100C000110000000000000000000000000000011
10000001000011111000000000001000000000000000100000000000000000000000100C00011000000000000000100C000111000000000000000000000000000011
10000111001000000000000000100000000011000000100000000000000000000000100C00011000000000000000100C000110000000000000000000000000000011
10000111001000000000000000100000000011000000100000011000000000000000100C00011000000000000000100C000000000000000000000000000000001111
10000111001000000000000000100000000011000000100000011000000000000000100C00011000000000000000100C000100000000000000000000000000000111
10000111001000000000000000100000000011000000100000011000000000000000100C00011000000000000000100C000111000000000000000000000000000001
10000111001000000000000000100000000011000000100000011000000000000000100C00011000000000000000100C000111000000000000000000000000000001
10000111001000000000000000100000000011000000100000011000000000000000100C00011000000000000000100C000111000000000000000000000000000001
10000111001000000000000000100000000011000000100000011000000000000000100C00011000000000000000100C000111000000000000000000000000000001
10000111001000000000000000100000000011000000100000011000000000000000100C00011000000000000000100C000111000000000000000000000000000001
10000111001000000000000000100000000011000000100000011000000000000000100C00011000000000000000100C000111000000000000000000000000000001
10000111001000000000000000100000000011000000100000011000000000000000100C00011000000000000000100C000111000000000000000000000000000001
10000111001000000000000000100000000011000000100000011000000000000000100C00011000000000000000100C000111000000000000000000000000000001
10000111001000000000000000100000000011000000100000011000000000000000100C00011000000000000000100C000111000000000000000000000000000001
10000111001000000000000000100000000011000000100000011000000000000000100C00011000000000000000100C000111000000000000000000000000000001
10000111001000000000000000100000000011000000100000011000000000000000100C00011000000000000000100C000111000000000000000000000000000001
10000111001000000000000000100000000011000000100000011000000000000000100C00011000000000000000100C000111000000000000000000000000000001
10000111001000000000000000100000000011000000100000011000000000000000100C00011000000000000000100C000111000000000000000000000000000001
10000111001000000000000000100000000011000000100000011000000000000000100C00011000000000000000100C000111000000000000000000000000000001
10000111001000000000000000100000000011000000100000011000000000000000100C00011000000000000000100C000111000000000000000000000000000001
10000111001000000000000000100000000011000000100000011000000000000000100C00011000000000000000100C000111000000000000000000000000000001
10000111001000000000000000100000000011000000100000011000000000000000100C00011000000000000000100C000111000000000000000000000000000001
10000111001000000000000000100000000011000000100000011000000000000000100C00011000000000000000100C000111000000000000000000000000000001
10000111001000000000000000100000000011000000100000011000000000000000100C00011000000000000000100C000111000000000000000000000000000001
10000111001000000000000000100000000011000000100000011000000000000000100C00011000000000000000100C000111000000000000000000000000000001
10000111001000000000000000100000000011000000100000011000000000000000100C00011000000000000000100C000111000000000000000000000000000001
10000111001000000000000000100000000011000000100000011000000000000000100C00011000000000000000100C000111000000000000000000000000000001
10000111001000000000000000100000000011000000100000011000000000000000100C00011000000000000000100C000111000000000000000000000000000001
10000111001000000000000000100000000011000000100000011000000000000000100C00011000000000000000100C000111000000000000000000000000000001
10000111001000000000000000100000000011000000100000011000000000000000100C00011000000000000000100C000111000000000000000000000000000001
10000111001000000000000000100000000011000000100000011000000000000000100C00011000000000000000100C000111000000000000000000000000000001
10000111001000000000000000100000000011000000100000011000000000000000100C00011000000000000000100C000111000000000000000000000000000001
10000111001000000000000000100000000011000000100000011000000000000000100C00011000000000000000100C000111000000000000000000000000000001
10000111001000000000000000100000000011000000100000011000000000000000100C00011000000000000000100C000111000000000000000000000000000001
10000111001000000000000000100000000011000000100000011000000000000000100C00011000000000000000100C000111000000000000000000000000000001
10000111001000000000000000100000000011000000100000011000000000000000100C00011000000000000000100C000111000000000000000000000000000001
10000111001000000000000000100000000011000000100000011000000000000000100C00011000000000000000100C000111000000000000000000000000000001
10000111001000000000000000100000000011000000100000011000000000000000100C00011000000000000000100C000111000000000000000000000000000001
10000111001000000000000000100000000011000000100000011000000000000000100C00011000000000000000100C000111000000000000000000000000000001
10000111001000000000000000100000000011000000100000011000000000000000100C00011000000000000000100C000111000000000000000000000000000001
10000111001000000000000000100000000011000000100000011000000000000000100C00011000000000000000100C000111000000000000000000000000000001
10000111001000000000000000100000000011000000100000011000000000000000100C00011000000000000000100C000111000000000000000000000000000001
10000111001000000000000000100000000011000000100000011000000000000000100C00011000000000000000100C000111000000000000000000000000000001
10000111001000000000000000100000000011000000100000011000000000000000100C00011000000000000000100C000111000000000000000000000000000001
10000111001000000000000000100000000011000000100000011000000000000000100C00011000000000000000100C000111000000000000000000000000000001
10000111001000000000000000100000000011000000100000011000000000000000100C00011000000000000000100C000111000000000000000000000000000001
10000111001000000000000000100000000011000000100000011000000000000000100C00011000000000000000100C000111000000000000000000000000000001
10000111001000000000000000100000000011000000100000011000000000000000100C00011000000000000000100C000111000000000000000000000000000001
10000111001000000000000000100000000011000000100000011000000000000000100C00011000000000000000100C000111000000000000000000000000000001
10000111001000000000000000100000000011000000100000011000000000000000100C00011000000000000000100C000111000000000000000000000000000001
10000111001000000000000000100000000011000000100000011000000000000000100C00011000000000000000100C000111000000000000000000000000000001
10000111001000000000000000100000000011000000100000011000000000000000100C00011000000000000000100C000111000000000000000000000000000001
10000111001000000000000000100000000011000000100000011000000000000000100C00011000000000000000100C000111000000000000000000000000000001
10000111001000000000000000100000000011000000100000011000000000000000100C00011000000000000000100C000111000000000000000000000000000001
10000111001000000000000000100000000011000000100000011000000000000000100C00011000000000000000100C000111000000000000000000000000000001
10000111001000000000000000100000000011000000100000011000000000000000100C00011000000000000000100C000111000000000000000000000000000001
10000111001000000000000000100000000011000000100000011000000000000000100C00011000000000000000100C000111000000000000000000000000000001
10000111001000000000000000100000000011000000100000011000000000000000100C00011000000000000000100C000111000000000000000000000000000001
10000111001000000000000000100000000011000000100000011000000000000000100C00011000000000000000100C000111000000000000000000000000000001
10000111001000000000000000100000000011000000100000011000000000000000100C00011000000000000000100C000111000000000000000000000000000001
10000111001000000000000000100000000011000000100000011000000000000000100C00011000000000000000100C000111000000000000000000000000000001
10000111001000000000000000100000000011000000100000011000000000000000100C00011000000000000000100C000111000000000000000000000000000001
10000111001000000000000000100000000011000000100000011000000000000000100C00011000000000000000100C000111000000000000000000000000000001
10000111001000000000000000100000000011000000100000011000000000000000100C00011000000000000000100C000111000000000000000000000000000001
10000111001000000000000000100000000011000000100000011000000000000000100C00011000000000000000100C000111000000000000000000000000000001
10000111001000000000000000100000000011000000100000011000000000000000100C00011000000000000000100C000111000000000000000000000000000001
10000111001000000000000000100000000011000000100000011000000000000000100C00011000000000000000100C000111000000000000000000000000000001
10000111001000000000000000100000000011000000100000011000000000000000100C00011000000000000000100C000111000000000000000000000000000001
10000111001000000000000000100000000011000000100000011000000000000000100C00011000000000000000100C000111000000000000000000000000000001
10000111001000000000000000100000000011000000100000011000000000000000100C00011000000000000000100C000111000000000000000000000000000001
10000111001000000000000000100000000011000000100000011000000000000000100C00011000000000000000100C000111000000000000000000000000000001
10000111001000000000000000100000000011000000100000011000000000000000100C00011000000000000000100C000111000000000000000000000000000001
10000111001000000000000000100000000011000000100000011000000000000000100C00011000000000000000100C000111000000000000000000000000000001
10000111001000000000000000100000000011000000100000011000000000000000100C00011000000000000000100C000111000000000000000000000000000001
10000111001000000000000000100000000011000000100000011000000000000000100C00011000000000000000100C000111000000000000000000000000000001
10000111001000000000000000100000000011000000100000011000000000000000100C00011000000000000000100C000111000000000000000000000000000001
10000111001000000000000000100000000011000000100000011000000000000000100C00011000000000000000100C000111000000000000000000000000000001
10000111001000000000000000100000000011000000100000011000000000000000100C00011000000000000000100C000111000000000000000000000000000001
10000111001000000000000000100000000011000000100000011000000000000000100C00011000000000000000100C000111000000000000000000000000000001
10000111001000000000000000100000000011000000100000011000000000000000100C00011000000000000000100C000111000000000000000000000000000001
10000111001000000000000000100000000011000000100000011000000000000000100C00011000000000000000100C000111000000000000000000000000000001
10000111001000000000000000100000000011000000100000011000000000000000100C00011000000000000000100C000111000000000000000000000000000001
10000111001000000000000000100000000011000000100000011000000000000000100C00011000000000000000100C000111000000000000000000000000000001
10000111001000000000000000100000000011000000100000011000000000000000100C00011000000000000000100C000111000000000000000000000000000001
10000111001000000000000000100000000011000000100000011000000000000000100C00011000000000000000100C000111000000000000000000000000000001
10000111001000000000000000100000000011000000100000011000000000000000100C00011000000000000000100C000111000000000000000000000000000001
10000111001000000000000000100000000011000000100000011000000000000000100C00011000000000000000100C000111000000000000000000000000000001
10000111001000000000000000100000000011000000100000011000000000000000100C00011000000000000000100C000111000000000000000000000000000001
10000111001000000000000000100000000011000000100000011000000000000000100C00011000000000000000100C000111000000000000000000000000000001
10000111001000000000000000100000000011000000100000011000000000000000100C00011000000000000000100C000111000000000000000000000000000001
10000111001000000000000000100000000011000000100000011000000000000000100C00011000000000000000100C000111000000000000000000000000000001
111111111111111111111111111111111111111111111111111111111111111111111111111111111111111111111111111111111111111111111111111111111111