1111111111111
10010000000C1
1000011111001
1P0011E000011
11000000C0011
1111111111111
