11111111111
11111111111
11111111111
11111111111
1PCCC0000E1
11111111111