111111
100101
100001
1P0011
110001
111111