11111111111111111
100100000000000C1
10000111110000001
10001100000000001
11000000C00000001
10P00100000E00001
10000111110000001
11111111111111111