1111111111111111111
10010000000C0000001
1000011111000000001
1P0011E000000000001
11000000C0000000001
1111111111111111111